111111111111111111111111
100C00C0000010C000000001
1111111000C000C011111001
1P00000001110000000000E1

1000000C0000000C00000001
111111111111111111111111