111111111111111111111111
100000000000100000000001
111111100000000011111001
1P00000001110000000000E1
100000111100000111000001
100000000000000000000001
111111111111111111111111