111111111111111111111111
100C00C0001010C000000001
11111110001000C011111001
1P00000001110000000000E1
100C00111100000111000001
1000000C0100000C00000001
111111111111111111111111